111111
101011
100001
110101
11E101
