11111111111111111111
10000100011010001001
11000001101000111101
E0000100100000000101
10100010101100010111
11000000000111100011
10010010001000000011
10010110100101001001
10100010000010100011
10001010000100110101
10010011000000001001
10000101010001111001
10100110000101010001
10000010000000110001
10000010010001100001
10000000110000000001
10000000000000011101
10110000100110010101
10011100000000001001
11111111111111111111
